x-------------------------------------------------x---
--xxxxx------------------------------------------xxx--
--x---x----xx------------------------------------xxx--
--x-x-x----xx-------------------------------------x---
--xxxxx----xx-----------------------------------------
--x-x-------------------------------------------------
--x--x------------------------------------------------
--x-----------x---------------------------------------
--------------x---------------------------------------
-------------xx-------------x------------------------x
